THE WOODS
80 20
1
3 12 17 0 0 7 5
176 94 176 176 94 176 176 94 176 176 94 176 176 94 176 32 32 32 176 94 176 176 94 176 176 94 176 176 94 176 176 94 176 176 94 176 176 94 176 176 94 176 176 94 176 176 94 176 176 94 176 176 94 176 176 94 176 176 94 176 176 94 176 176 94 176 176 94 176 176 94 176 176 94 176 176 94 176 176 94
47 32 92 47 32 92 47 32 92 47 32 92 47 32 92 32 32 32 47 32 92 47 32 92 47 32 92 47 32 92 47 32 92 47 32 92 47 32 92 47 32 92 47 32 92 47 32 92 47 32 92 47 32 92 47 32 92 47 32 92 47 32 92 47 32 92 47 32 92 47 32 92 47 32 92 47 32 92 47 32
47 32 92 47 32 92 47 32 92 47 32 92 47 32 92 32 32 32 47 32 92 47 32 92 47 32 92 47 32 92 47 32 92 47 32 92 47 32 92 47 32 92 47 32 92 47 32 92 47 32 92 47 32 92 47 32 92 47 32 92 47 32 92 47 32 92 47 32 92 47 32 92 47 32 92 47 32 92 47 32
176 186 176 176 186 176 176 186 176 176 186 176 176 186 176 32 32 32 176 186 176 176 186 176 176 186 176 176 186 176 176 186 176 176 186 176 176 186 176 176 186 176 176 186 176 176 186 176 176 186 176 176 186 176 176 186 176 176 186 176 176 186 176 176 186 176 176 186 176 176 186 176 176 186 176 176 186 176 176 186
176 176 176 176 176 176 176 176 176 176 176 176 176 176 176 32 32 32 176 176 176 176 176 176 176 176 176 176 176 176 176 176 176 176 176 176 176 176 176 176 176 176 176 176 176 176 176 176 176 176 176 176 176 176 176 176 176 176 176 176 176 176 176 176 176 176 176 176 176 176 176 176 176 176 176 176 176 176 176  176
176 94 176 176 94 176 176 94 176 176 94 176 176 94 176 32 32 32 176 94 176 176 94 176 176 94 176 176 94 176 176 94 176 176 94 176 176 94 176 176 94 176 176 94 176 176 94 176 176 94 176 176 94 176 176 94 176 176 94 176 176 94 176 176 94 176 176 94 176 176 94 176 176 94 176 176 94 176 176 94
47 32 92 47 32 92 47 32 92 47 32 92 47 32 92 32 32 32 47 32 92 47 32 92 47 32 92 47 32 92 47 32 92 47 32 92 47 32 92 47 32 92 47 32 92 47 32 92 47 32 92 47 32 92 47 32 92 47 32 92 47 32 92 47 32 92 47 32 92 47 32 92 47 32 92 47 32 92 47 32
47 32 92 47 32 92 47 32 92 47 32 92 47 32 92 32 32 32 47 32 92 47 32 92 47 32 92 47 32 92 47 32 92 47 32 92 47 32 92 47 32 92 47 32 92 47 32 92 47 32 92 47 32 92 47 32 92 47 32 92 47 32 92 47 32 92 47 32 92 47 32 92 47 32 92 47 32 92 47 32
176 186 176 176 186 176 176 186 176 176 186 176 176 186 176 32 32 32 176 186 176 176 186 176 176 186 176 176 186 176 176 186 176 176 186 176 176 186 176 176 186 176 176 186 176 176 186 176 176 186 176 176 186 176 176 186 176 176 186 176 176 186 176 176 186 176 176 186 176 176 186 176 176 186 176 176 186 176 176 186
32 32 32 32 32 32 32 32 32 32 32 32 32 32 32 32 32 32 32 32 32 32 32 32 32 32 32 32 32 32 32 32 32 32 32 32 32 32 32 32 32 32 32 32 32 32 32 32 32 32 32 32 32 32 32 32 32 32 32 32 32 32 32 32 32 32 32 32 32 32 32 32 32 32 32 32 32 32 32 32 
32 32 32 32 32 32 32 32 32 32 32 32 32 32 32 32 32 32 32 32 32 32 32 32 32 32 32 32 32 32 32 32 32 32 32 32 32 32 32 32 32 32 32 32 32 32 32 32 32 32 32 32 32 32 32 32 32 32 32 32 32 32 32 32 32 32 32 32 32 32 32 32 32 32 32 32 32 32 32 32
176 94 176 176 94 176 176 94 176 176 94 176 176 94 176 32 32 32 176 94 176 176 94 176 176 94 176 176 94 176 176 94 176 176 94 176 176 94 176 176 94 176 176 94 176 176 94 176 176 94 176 176 94 176 176 94 176 176 94 176 176 94 176 176 94 176 176 94 176 176 94 176 176 94 176 176 94 176 176 94
47 32 92 47 32 92 47 32 92 47 32 92 47 32 92 32 32 32 47 32 92 47 32 92 47 32 92 47 32 92 47 32 92 47 32 92 47 32 92 47 32 92 47 32 92 47 32 92 47 32 92 47 32 92 47 32 92 47 32 92 47 32 92 47 32 92 47 32 92 47 32 92 47 32 92 47 32 92 47 32
47 32 92 47 32 92 47 32 92 47 32 92 47 32 92 32 32 32 47 32 92 47 32 92 47 32 92 47 32 92 47 32 92 47 32 92 47 32 92 47 32 92 47 32 92 47 32 92 47 32 92 47 32 92 47 32 92 47 32 92 47 32 92 47 32 92 47 32 92 47 32 92 47 32 92 47 32 92 47 32
176 186 176 176 186 176 176 186 176 176 186 176 176 186 176 32 32 32 176 186 176 176 186 176 176 186 176 176 186 176 176 186 176 176 186 176 176 186 176 176 186 176 176 186 176 176 186 176 176 186 176 176 186 176 176 186 176 176 186 176 176 186 176 176 186 176 176 186 176 176 186 176 176 186 176 176 186 176 176 186
176 176 176 176 176 176 176 176 176 176 176 176 176 176 176 32 32 32 176 176 176 176 176 176 176 176 176 176 176 176 176 176 176 176 176 176 176 176 176 176 176 176 176 176 176 176 176 176 176 176 176 176 176 176 176 176 176 176 176 176 176 176 176 176 176 176 176 176 176 176 176 176 176 176 176 176 176 176 176  176
176 94 176 176 94 176 176 94 176 176 94 176 176 94 176 32 32 32 176 94 176 176 94 176 176 94 176 176 94 176 176 94 176 176 94 176 176 94 176 176 94 176 176 94 176 176 94 176 176 94 176 176 94 176 176 94 176 176 94 176 176 94 176 176 94 176 176 94 176 176 94 176 176 94 176 176 94 176 176 94
47 32 92 47 32 92 47 32 92 47 32 92 47 32 92 32 32 32 47 32 92 47 32 92 47 32 92 47 32 92 47 32 92 47 32 92 47 32 92 47 32 92 47 32 92 47 32 92 47 32 92 47 32 92 47 32 92 47 32 92 47 32 92 47 32 92 47 32 92 47 32 92 47 32 92 47 32 92 47 32
47 32 92 47 32 92 47 32 92 47 32 92 47 32 92 32 32 32 47 32 92 47 32 92 47 32 92 47 32 92 47 32 92 47 32 92 47 32 92 47 32 92 47 32 92 47 32 92 47 32 92 47 32 92 47 32 92 47 32 92 47 32 92 47 32 92 47 32 92 47 32 92 47 32 92 47 32 92 47 32
176 186 176 176 186 176 176 186 176 176 186 176 176 186 176 32 32 32 176 186 176 176 186 176 176 186 176 176 186 176 176 186 176 176 186 176 176 186 176 176 186 176 176 186 176 176 186 176 176 186 176 176 186 176 176 186 176 176 186 176 176 186 176 176 186 176 176 186 176 176 186 176 176 186 176 176 186 176 176 186