THE VILLAGE
80 20
1
2 7 4 58 15
5 17 0 0 15 18 18 0 0 16 18 19 0 0 17 18 3 10 3 9 7 3 11 3 10 7
94 176 176 94 176 176 94 176 176 94 176 176 94 176 176 94 176 32 32 32 176 94 176 176 94 176 176 94 176 176 94 176 176 94 176 176 94 176 176 94 176 176 94 176 176 94 176 176 94 176 176 94 176 176 94 176 176 94 176 176 94 176 176 94 176 176 94 176 176 94 176 176 94 176 176 94 176 176 94 176
32 92 47 32 92 47 32 92 47 32 92 47 32 92 47 32 92 32 32 32 47 32 92 47 32 92 47 32 92 47 32 92 47 32 92 47 32 92 47 32 92 47 32 92 47 32 92 47 32 92 47 32 92 47 32 92 47 32 92 47 32 92 47 32 92 47 32 92 47 32 92 47 32 92 47 32 92 47 32 92
32 92 47 32 92 47 32 92 47 32 92 47 32 92 47 32 92 32 32 32 47 32 92 47 32 92 47 32 92 47 32 92 47 32 92 47 32 92 47 32 92 47 32 92 47 32 92 47 32 92 47 32 92 47 32 92 47 32 92 47 32 92 47 32 92 47 32 92 47 32 92 47 32 92 47 32 92 47 32 92
186 176 176 186 176 176 186 176 176 186 176 176 186 176 176 186 176 32 32 32 176 186 176 176 186 176 176 186 176 176 186 176 176 186 176 176 186 176 176 186 176 176 186 176 176 186 176 176 186 176 176 186 176 176 186 176 176 186 176 176 186 176 176 186 176 176 186 176 176 186 176 176 186 176 176 186 176 176 186 176
94 176 176 176 206 176 176 32 32 176 176 206 176 176 176 94 176 32 32 32 176 176 176 176 176 176 176 176 176 176 176 176 176 176 176 176 176 176 176 176 176 176 47 47 47 47 47 47 92 92 92 92 92 92 176 176 176 176 176 176 176 176 176 176 176 176 176 176 176 176 176 176 176 176 176 176 176 176 94  176
32 92 176 176 178 176 176 32 32 176 176 178 176 176 47 32 92 32 32 32 176 176 176 176 176 176 176 176 176 176 176 176 176 176 176 176 176 176 176 176 176 176 124 95 95 95 95 124 124 95 95 95 95 124 176 176 176 176 176 176 176 176 176 176 176 176 176 176 176 176 176 176 176 176 176 176 176 47 32 92
32 92 176 176 176 176 176 32 32 176 176 176 176 176 47 32 92 32 32 32 176 176 176 47 47 47 47 47 47 92 176 176 176 176 176 176 176 176 176 176 176 176 124 95 95 95 95 124 124 95 95 95 95 124 176 176 176 176 176 176 176 176 176 176 176 176 176 47 92 92 92 92 92 92 176 176 176 47 32 92
186 176 176 176 206 176 176 32 32 176 176 206 176 176 176 186 176 32 32 32 176 176 176 124 95 95 95 95 124 124 176 176 176 47 47 47 47 47 47 92 176 176 176 176 176 176 176 32 32 176 176 176 176 176 176 176 47 92 92 92 92 92 92 176 176 176 176 124 124 95 95 95 95 124 176 176 176 176 186 176
94 176 176 176 178 176 176 32 32 176 176 178 176 176 176 176 176 32 32 32 176 176 176 176 176 176 176 176 32 32 176 176 176 124 95 95 95 95 124 124 176 176 176 176 176 176 176 32 32 176 176 176 176 176 176 176 124 124 95 95 95 95 124 176 176 176 176 32 32 176 176 176 176 176 176 176 176 176 94 176
32 92 176 176 176 176 176 32 32 176 176 176 176 176 176 176 176 32 32 32 176 176 176 176 176 176 176 176 32 32 176 176 176 176 176 176 176 176 32 32 176 176 176 176 176 176 176 32 32 176 176 176 176 176 176 176 32 32 176 176 176 176 176 176 176 176 176 32 32 176 176 176 176 176 176 176 176 47 32 92
32 92 32 32 32 32 32 32 32 32 32 32 32 32 32 32 32 32 32 32 32 32 32 32 32 32 32 32 32 32 32 32 32 32 32 32 32 32 32 32 32 32 32 32 32 32 32 32 32 32 32 32 32 32 32 32 32 32 32 32 32 32 32 32 32 32 32 32 32 32 32 32 32 32 32 32 32 47 32 92
186 176 32 32 32 32 32 32 32 32 32 32 32 32 32 32 32 32 32 32 32 32 32 32 32 32 32 32 32 32 32 32 32 32 32 32 32 32 32 32 32 32 32 32 32 32 32 32 32 32 32 32 32 32 32 32 32 32 32 32 32 32 32 32 32 32 32 32 32 32 32 32 32 32 32 32 32 176 186 176
176 176 94 176 176 94 176 32 32 176 94 176 176 94 176 176 94 176 176 94 176 176 94 176 176 94 176 176 94 176 176 94 176 176 176 176 176 176 176 176 176 176 176 176 176 176 176 179 179 176 176 176 176 176 176 176 176 176 176 176 176 176 176 176 176 176 94 176 176 94 176 176 94 176 176 94 176 176 94  176
176 47 32 92 47 32 92 32 32 47 32 92 47 32 92 47 32 92 47 32 92 47 32 92 47 32 92 47 32 92 47 32 92 176 176 126 126 126 126 126 126 126 126 126 126 126 126 179 179 126 126 126 126 126 126 126 126 126 126 126 126 126 176 176 176 47 32 92 47 32 92 47 32 92 47 32 92 47 32 92
176 47 32 92 47 32 92 32 32 47 32 92 47 32 92 47 32 92 47 32 92 47 32 92 47 32 92 47 32 92 47 32 92 176 126 126 126 126 126 126 126 126 126 126 126 126 126 179 179 126 126 126 126 126 126 126 126 126 126 126 126 126 126 176 176 47 32 92 47 32 92 47 32 92 47 32 92 47 32 92
176 176 186 176 176 186 176 32 32 176 186 176 176 186 176 176 186 176 176 186 176 176 186 176 176 186 176 176 186 176 176 186 176 126 126 126 126 126 179 179 179 179 179 179 179 179 179 179 179 179 179 179 179 179 179 179 179 179 179 126 126 126 126 126 176 176 186 176 176 186 176 176 186 176 176 186 176 176 186 176
176 94 176 176 176 94 176 32 32 176 94 176 176 94 176 176 94 176 176 94 176 176 94 176 176 94 176 176 94 176 176 94 176 126 126 126 126 126 126 126 126 126 126 126 126 126 126 179 179 126 126 126 126 126 126 126 126 126 126 126 126 126 126 126 176 176 94 176 176 94 176 176 94 176 176 94 176 176 94  176
47 32 92 176 47 32 92 32 32 47 32 92 47 32 92 47 32 92 47 32 92 47 32 92 47 32 92 47 32 92 47 32 92 176 126 126 126 126 126 126 126 126 126 126 126 126 126 179 179 126 126 126 126 126 126 126 126 126 126 126 126 126 126 176 176 47 32 92 47 32 92 47 32 92 47 32 92 47 32 92
47 32 92 176 47 32 92 32 32 47 32 92 47 32 92 47 32 92 47 32 92 47 32 92 47 32 92 47 32 92 47 32 92 176 176 126 126 126 126 126 126 126 126 126 126 126 126 126 126 126 126 126 126 126 126 126 126 126 126 126 126 126 176 176 176 47 32 92 47 32 92 47 32 92 47 32 92 47 32 92
176 186 176 176 176 186 176 32 32 176 186 176 176 186 176 176 186 176 176 186 176 176 186 176 176 186 176 176 186 176 176 186 176 176 176 176 176 176 176 176 176 176 176 176 176 176 176 176 176 176 176 176 176 176 176 176 176 176 176 176 176 176 176 176 176 176 186 176 176 186 176 176 186 176 176 186 176 176 186 176