THE BRIDGE
80 20
2
1 3 9
176 94 176 176 94 176 176 94 176 176 94 176 176 94 176 176 94 176 176 94 176 176 94 176 176 94 176 176 94 176 176 94 176 176 94 176 32 32 32 32 32 32 32 32 32 32 32 32 32 32 32 176 94 176 176 94 176 176 94 176 176 94 176 176 94 176 176 94 176 176 94 176 176 94 176 176 94 176 176 94
47 32 92 47 32 92 47 32 92 47 32 92 47 32 92 47 32 92 47 32 92 47 32 92 47 32 92 47 32 92 47 32 92 47 32 92 176 32 32 32 32 32 32 32 32 32 32 32 32 32 176 47 32 92 47 32 92 47 32 92 47 32 92 47 32 92 47 32 92 47 32 92 47 32 92 47 32 92 47 32
47 32 92 47 32 92 47 32 92 47 32 92 47 32 92 47 32 92 47 32 92 47 32 92 47 32 92 47 32 92 47 32 92 47 32 92 176 176 32 32 32 32 32 32 32 32 32 32 32 176 176 47 32 92 47 32 92 47 32 92 47 32 92 47 32 92 47 32 92 47 32 92 47 32 92 47 32 92 47 32
176 186 176 176 186 176 176 186 176 176 186 176 176 186 176 176 186 176 176 186 176 176 186 176 176 186 176 176 186 176 176 186 176 176 186 176 176 176 32 32 32 32 32 32 32 32 32 32 32 176 176 176 186 176 176 186 176 176 186 176 176 186 176 176 186 176 176 186 176 176 186 176 176 186 176 176 186 176 176 186
176 94 176 176 94 176 176 94 176 176 94 176 176 94 176 176 94 176 176 94 176 176 94 176 176 176 176 176 176 176 176 176 176 176 176 176 176 176 32 32 32 32 32 32 32 32 32 32 32 176 176 176 176 176 176 176 176 176 176 176 176 176 176 176 176 176 176 176 176 176 176 176 176 176 176 176 176 176 176 176
47 32 92 47 32 92 47 32 92 47 32 92 47 32 92 47 32 92 47 32 92 47 32 92 176 47 47 47 47 47 47 47 92 176 176 176 176 176 32 32 32 32 32 32 32 32 32 32 32 176 176 176 94 176 176 94 176 176 94 176 176 94 176 176 94 176 176 94 176 176 94 176 176 94 176 176 94 176 176 94
47 32 92 47 32 92 47 32 92 47 32 92 47 32 92 47 32 92 47 32 92 47 32 92 176 124 95 95 95 95 95 124 124 176 176 176 176 176 32 32 32 32 32 32 32 32 32 32 32 176 176 47 32 92 47 32 92 47 32 92 47 32 92 47 32 92 47 32 92 47 32 92 47 32 92 47 32 92 47 32
176 186 176 176 186 176 176 186 176 176 186 176 186 176 176 186 176 176 186 176 176 186 176 176 176 176 176 176 176 176 176 32 32 176 176 176 176 32 32 32 32 32 32 32 32 32 32 32 32 32 176 47 32 92 47 32 92 47 32 92 47 32 92 47 32 92 47 32 92 47 32 92 47 32 92 47 32 92 47 32
176 94 176 176 176 176 176 176 176 176 176 176 176 176 176 176 176 176 176 176 176 176 176 176 176 176 176 176 176 176 176 32 32 176 176 205 205 205 205 205 205 205 205 205 205 205 205 205 205 205 205 205 186 176 176 186 176 176 186 176 176 186 176 176 186 176 176 186 176 176 186 176 176 186 176 176 186 176 176 186
47 32 92 32 32 32 32 32 32 32 32 32 32 32 32 32 32 32 32 32 32 32 32 32 32 32 32 32 32 32 32 32 32 32 32 179 179 179 179 179 179 179 179 179 179 179 179 179 179 179 179 179 32 32 32 32 32 32 32 32 32 32 32 32 32 32 32 32 32 32 32 32 32 32 32 32 32 32 32 32
47 32 92 32 32 32 32 32 32 32 32 32 32 32 32 32 32 32 32 32 32 32 32 32 32 32 32 32 32 32 32 32 32 32 32 179 179 179 179 179 179 179 179 179 179 179 179 179 179 179 179 179 32 32 32 32 32 32 32 32 32 32 32 32 32 32 32 32 32 32 32 32 32 32 32 32 32 32 32 32
176 186 176 176 94 176 176 94 176 176 94 176 176 94 176 32 32 32 176 94 176 176 94 176 176 94 176 176 94 176 176 94 176 176 94 205 205 205 205 205 205 205 205 205 205 205 205 205 205 205 205 205 94 176 176 94 176 176 94 176 176 94 176 176 94 176 176 94 176 176 94 176 176 94 176 176 94 176 176 94
176 94 176 47 32 92 47 32 92 47 32 92 47 32 92 32 32 32 47 32 92 47 32 92 47 32 92 47 32 92 47 32 92 47 32 92 176 32 32 32 32 32 32 32 32 32 32 32 32 32 176 47 32 92 47 32 92 47 32 92 47 32 92 47 32 92 47 32 92 47 32 92 47 32 92 47 32 92 47 32
47 32 92 47 32 92 47 32 92 47 32 92 47 32 92 32 32 32 47 32 92 47 32 92 47 32 92 47 32 92 47 32 92 47 32 92 176 32 32 32 32 32 32 32 32 32 32 32 32 176 176 47 32 92 47 32 92 47 32 92 47 32 92 47 32 92 47 32 92 47 32 92 47 32 92 47 32 92 47 32
47 32 92 176 186 176 176 186 176 176 186 176 176 186 176 32 32 32 176 186 176 176 186 176 176 186 176 176 186 176 176 186 176 176 186 176 176 32 32 32 32 32 32 32 32 32 32 32 32 176 176 176 186 176 176 186 176 176 186 176 176 186 176 176 186 176 176 186 176 176 186 176 176 186 176 176 186 176 176 186
176 186 176 176 176 176 176 176 176 176 176 176 176 176 176 32 32 32 176 176 176 176 176 176 176 176 176 176 176 176 176 176 176 176 176 176 176 32 32 32 32 32 32 32 32 32 32 32 32 176 176 176 176 176 176 176 176 176 176 176 176 176 176 176 176 176 176 176 176 176 176 176 176 176 176 176 176 176 176 176
176 94 176 176 94 176 176 94 176 176 94 176 176 94 176 32 32 32 176 94 176 176 94 176 176 94 176 176 94 176 176 94 176 176 94 176 176 32 32 32 32 32 32 32 32 32 32 32 32 176 176 176 94 176 176 94 176 176 94 176 176 94 176 176 94 176 176 94 176 176 94 176 176 94 176 176 94 176 176 94
47 32 92 47 32 92 47 32 92 47 32 92 47 32 92 32 32 32 47 32 92 47 32 92 47 32 92 47 32 92 47 32 92 47 32 92 176 32 32 32 32 32 32 32 32 32 32 32 32 176 176 47 32 92 47 32 92 47 32 92 47 32 92 47 32 92 47 32 92 47 32 92 47 32 92 47 32 92 47 32
47 32 92 47 32 92 47 32 92 47 32 92 47 32 92 32 32 32 47 32 92 47 32 92 47 32 92 47 32 92 47 32 92 47 32 92 176 32 32 32 32 32 32 32 32 32 32 32 32 32 176 47 32 92 47 32 92 47 32 92 47 32 92 47 32 92 47 32 92 47 32 92 47 32 92 47 32 92 47 32
176 186 176 176 186 176 176 186 176 176 186 176 176 186 176 32 32 32 176 186 176 176 186 176 176 186 176 176 186 176 176 186 176 176 186 176 32 32 32 32 32 32 32 32 32 32 32 32 32 32 32 176 186 176 176 186 176 176 186 176 176 186 176 176 186 176 176 186 176 176 186 176 176 186 176 176 186 176 176 186

