THE MAZE
80 20
1
1 72 10
3 14 0 1 7 18 15 0 1 8 18 16 0 1 8 18
176 94 176 176 94 176 64 176 176 94 176 176 94 176 32 32 32 176 176 94 176 176 94 176 176 94 176 176 94 176 176 94 176 176 94 176 176 94 176 176 94 176 176 94 176 176 94 176 176 94 176 176 94 176 176 94 176 176 94 176 176 94 176 176 94 176 176 94 176 176 94 176 176 94 176 176 94 176 176  94
47 32 92 47 32 92 176 64 47 32 92 47 32 92 32 32 32 176 47 32 92 47 32 92 47 32 92 47 32 92 47 32 92 47 32 92 47 32 92 47 32 92 47 32 92 47 32 92 47 32 92 47 32 92 47 32 92 47 32 92 47 32 92 47 32 92 47 32 92 47 32 92 47 32 92 47 32 92 47 32
47 32 92 47 32 92 64 176 47 32 92 47 32 92 32 32 32 176 47 32 92 47 32 92 47 32 92 47 32 92 47 32 92 47 32 92 47 32 92 47 32 92 47 32 92 47 32 92 47 32 92 47 32 92 47 32 92 47 32 92 47 32 92 47 32 92 47 32 92 47 32 92 47 32 92 47 32 92 47 32
176 186 176 176 186 176 124 124 176 186 176 176 186 176 32 32 32 176 176 186 176 176 186 176 176 186 176 176 186 176 176 186 176 176 186 176 176 186 176 176 186 176 176 186 176 176 186 176 176 186 176 176 186 176 176 186 176 176 186 176 176 186 176 176 186 176 176 186 176 176 186 176 176 186 176 176 186 176 176 186
176 94 176 47 47 47 47 47 47 47 92 176 94 176 32 32 32 176 176 176 176 176 176 176 176 176 176 176 176 176 176 176 176 176 176 176 176 176 176 176 176 176 176 176 176 176 176 176 176 176 176 176 176 176 176 176 176 176 176 176 176 176 176 176 176 176 176 176 176 176 176 176 176 176 176 176 94 176 176  94
47 32 92 124 95 95 95 95 95 124 124 47 32 92 32 32 32 176 176 176 176 177 177 177 177 177 177 177 177 177 177 177 177 177 177 177 177 177 177 177 177 177 177 177 177 177 177 177 177 177 177 177 177 177 177 177 177 177 177 177 177 177 177 177 177 177 177 177 177 177 177 177 177 177 176 47 32 92 47 32
47 32 92 176 94 176 176 94 176 32 32 47 32 92 32 32 32 176 176 176 176 177 32 32 32 32 32 32 32 32 32 32 32 177 32 32 32 177 32 32 32 32 32 32 32 32 32 32 32 32 177 32 32 32 32 32 32 32 32 32 32 32 32 32 32 32 32 32 32 32 32 32 32 177 176 47 32 92 47 32
176 186 176 47 32 92 47 32 92 32 32 176 186 176 32 32 32 176 176 176 176 177 32 177 32 177 32 177 177 177 177 177 32 177 32 177 32 177 177 177 177 177 177 177 177 177 177 177 177 177 177 177 177 177 177 177 177 177 177 177 32 177 177 177 177 177 177 177 177 177 177 177 32 177 176 176 186 176 176 186
176 94 176 47 32 92 47 32 92 32 32 176 176 176 32 32 32 176 176 176 176 177 32 177 32 177 32 32 32 32 32 177 32 177 32 32 32 177 32 32 32 32 177 32 32 32 32 32 32 32 32 32 32 32 32 32 32 32 32 32 32 32 32 32 32 32 32 177 32 32 32 32 32 177 176 176 94 176 176  94
47 32 92 176 186 176 176 186 176 32 32 61 61 176 32 32 32 176 177 177 177 177 32 177 32 177 32 177 177 177 32 177 177 177 32 177 177 177 32 177 177 177 177 177 177 177 32 177 177 177 177 177 177 177 177 177 177 177 177 177 32 177 177 177 177 177 177 32 177 177 32 177 177 177 176 47 32 92 47 32
47 32 92 32 32 32 32 32 32 32 32 32 32 32 32 32 32 32 32 32 32 32 32 177 32 177 32 32 32 177 32 177 32 32 32 177 32 32 32 32 32 32 32 32 32 32 32 32 32 32 32 32 32 32 32 32 32 32 32 32 32 32 32 32 177 32 32 32 177 32 32 32 32 177 176 47 32 92 47 32
176 186 176 32 32 32 32 32 32 32 32 32 32 32 32 32 32 32 32 32 32 32 32 177 32 177 177 177 177 177 32 177 32 177 177 177 177 177 32 177 177 32 177 177 177 177 177 177 177 177 177 177 177 177 177 177 177 177 177 177 32 177 177 177 177 32 177 177 177 177 177 177 177 177 176 176 186 176 176 186
176 94 176 176 94 176 176 94 176 176 94 176 176 94 176 176 94 176 177 177 177 177 32 177 32 177 32 32 32 177 32 32 32 32 32 32 32 32 32 32 32 32 177 32 32 32 32 32 32 32 32 32 32 32 32 32 32 32 32 32 32 32 32 32 177 32 177 32 32 177 32 32 32 177 176 176 94 176 176  94
47 32 92 47 32 92 47 32 92 47 32 92 47 32 92 47 32 92 176 176 176 177 32 177 177 177 177 177 32 177 32 177 32 177 177 32 177 177 177 177 177 177 177 177 177 177 177 32 177 177 177 177 177 177 177 177 177 177 177 177 177 177 177 177 177 32 177 32 177 177 177 177 32 177 176 47 32 92 47 32
47 32 92 47 32 92 47 32 92 47 32 92 47 32 92 47 32 92 176 176 176 177 32 32 32 32 32 32 32 177 32 177 32 32 32 32 32 32 32 32 32 32 32 32 32 32 32 32 32 32 32 32 177 32 32 32 32 32 32 32 32 32 32 32 32 32 32 32 32 32 32 32 32 177 176 47 32 92 47 32
176 186 176 176 186 176 176 186 176 176 186 176 176 186 176 176 186 176 176 176 176 177 177 177 177 177 177 177 177 177 177 177 177 177 177 177 177 177 177 177 177 177 177 177 177 177 177 177 177 177 177 177 177 177 177 177 177 177 177 177 177 177 177 177 177 177 177 177 177 177 177 177 177 177 176 176 186 176 176 186
176 94 176 176 94 176 176 94 176 176 94 176 176 94 176 176 94 176 176 94 176 176 94 176 176 94 176 176 94 176 176 94 176 176 94 176 176 94 176 176 94 176 176 94 176 176 94 176 176 94 176 176 94 176 176 94 176 176 94 176 176 94 176 176 94 176 176 94 176 176 94 176 176 94 176 176 94 176 176  94
47 32 92 47 32 92 47 32 92 47 32 92 47 32 92 47 32 92 47 32 92 47 32 92 47 32 92 47 32 92 47 32 92 47 32 92 47 32 92 47 32 92 47 32 92 47 32 92 47 32 92 47 32 92 47 32 92 47 32 92 47 32 92 47 32 92 47 32 92 47 32 92 47 32 92 47 32 92 47 32
47 32 92 47 32 92 47 32 92 47 32 92 47 32 92 47 32 92 47 32 92 47 32 92 47 32 92 47 32 92 47 32 92 47 32 92 47 32 92 47 32 92 47 32 92 47 32 92 47 32 92 47 32 92 47 32 92 47 32 92 47 32 92 47 32 92 47 32 92 47 32 92 47 32 92 47 32 92 47 32
176 186 176 176 186 176 176 186 176 176 186 176 176 186 176 176 186 176 176 186 176 176 186 176 176 186 176 176 186 176 176 186 176 176 186 176 176 186 176 176 186 176 176 186 176 176 186 176 176 186 176 176 186 176 176 186 176 176 186 176 176 186 176 176 186 176 176 186 176 176 186 176 176 186 176 176 186 176 176 186	

