THE FRONTYARD
80 20
1
1 16 4 2
4 58 9 5 1 9 58 10 5 1 10 0 9 2 78 9 0 10 2 78 10
176  176    94    176  176    94    176  176    94    176  176    94    176  176    94    176  176    94    176  176    94     176   176    94    176  176    94     176    176    94    176  176    94    176   176    94    176  176  94    176  176    94    176  176    94    176  176    94    176  176  176  176   176   176   176   176   176   176  176   186    92   177   177   177   177   177   177   177   177   177   177   177   177   177   177   177   177   177 177   47
92    47    32    92    47    32    92    47    32    92    47    32    92    47    32    92    47    32    92    47    32     92     47    32    92    47    32     92     47     32    92    47    32    92    47     32    92    47  32    92    47    32    92    47    32    92    47    32    92   176  176  176   176   176   176   176   176   176  176   186   177    92   177   177   177   177   177   177   177   177   177   177   177   177   177   177   177   177  47  177
92    47    32    92    47    32    92    47    32    92    47    32    92    47    32    92    47    32    92    47    32     92     47    32    92    47    32     92     47     32    92    47    32    92    47     32    92    47  32    92    47    32    92    47    32    92    47    32    92   176  176  42    42    42    42    42    42    42   42    186   177   177    92   177   177   177   177   177   177   177   177   177   177   177   177   177   177    47 177  177
176  176    186   176  176    186   176  176    186   176  176    186   176  176    186   176  176    186   176  176    186    176   176    186   176  176    186    176    176    186   176  176    186   176   176    186   176  176  186   176  176    186   176  176    186   176  176    186   176  176  176  42    201   205   205   205   205   205  205   186   177   177   177    92   177   177   177   177   177   177   177   177   177   177   177   177    47   177 177  177
176  176    176   176  176    176   176  176    176   176  176    176   176  176    176   176   32    32    32    32    32     32     32    32    32    32    32     32     32     32    32    32    32    32    32     32    32    32  32    32   176    176   176  176    176   176  176    176   176  176  176  42    186   32    32    32    32    32   32    186   177   177   177   177    92   177   177   177   177   177   177   177   177   177   177    47   177   177 177  177
176  176    94    176  176    94    176  176    94    176  176    94    176  176    94    176   32    32    32    32    32     32     32    32    32    32    32     32     32     32    32    32    32    32    32     32    32    32  32    32   176    94    176  176    94    176  176    94    176  176  176  42    186   32    201   205   205   205  205   186   177   177   177   177   177    92   177   177   177   177   177   177   177   177    47   177   177   177 177  177
92    47    32    92    47    32    92    47    32    92    47    32    92    47    32    92    32    32    32   176    176    176   176    176   176  176    176    176    176    176   176  176    176   176   176    176   176   32  32    32    47    32    92    47    32    92    47    32    92   176  176  42    186   32    186   32    32    32   79    186   177   177   177   177   177   177    92   177   177   177   177   177   177    47   177   177   177   177 177  177
92    47    32    92    47    32    92    47    32    92    47    32    92    47    32    92    32    32    32   176    42     201   205    205   205  205    205    203    203    205   205  205    205   205   187    42    176   32  32    32    47    32    92    47    32    92    47    32    92   42   42   42    186   32    186   32    201   205  205   186   177   177   177   177   177   177   177    92   177   177   177   177    47   177   177   177   177   177 177  177
176  176    186   176  176    186   176  176    186   176  176    186   176  176    186   176   32    32    32   176    42     186   126    126   126  126    126    186    186    126   126  126    126   126   186    42    176   32  32    32   176    186   176  176    186   176  176    186   176  205  205  205   188   32    186   32    186   32   32    186   177   177   177   177   177   177   177   177    92   177   177    47   177   177   177   177   177   177 177  177
32    32    32    32    32    32    32    32    32    32    32    32    32    32    32    32    32    32    32   176    42     204   205    205   205  205    205    201    187    205   205  205    205   205   185    42    176   32  32    32    32    32    32    32    32    32    32    32    32   32   32   32    32    32    32    32    32    32   32    186   177   177   177   177   177   177   177   177   177    92    47   177   177   177   177   177   177   177 177  177
32    32    32    32    32    32    32    32    32    32    32    32    32    32    32    32    32    32    32   176    42     204   205    205   205  205    205    200    188    205   205  205    205   205   185    42    176   32  32    32    32    32    32    32    32    32    32    32    32   32   32   32    32    32    32    32    32    32   32    186   177   177   177   177   177   177   177   177   177    47    92   177   177   177   177   177   177   177 177  177
176  176    94    176  176    94    176  176    94    176  176    94    176  176    94    176   32    32    32   176    42     186   126    126   126  126    126    186    186    126   126  126    126   126   186    42    176   32  32    32   176    94    176  176    94    176  176    94    176  205  205  205   187   32    186   32    186   32   32    186   177   177   177   177   177   177   177   177    47   177   177    92   177   177   177   177   177   177 177  177
92    47    32    92    47    32    92    47    32    92    47    32    92    47    32    92    32    32    32   176    42     200   205    205   205  205    205    202    202    205   205  205    205   205   188    42    176   32  32    32    47    32    92    47    32    92    47    32    92   42   42   42    186   32    186   32    200   205  205   186   177   177   177   177   177   177   177    47   177   177   177   177    92   177   177   177   177   177 177  177
92    47    32    92    47    32    92    47    32    92    47    32    92    47    32    92    32    32    32   176    176    176   176    176   176  176    176    176    176    176   176  176    176   176   176    176   176   32  32    32    47    32    92    47    32    92    47    32    92   176  176  42    186   32    186   32    32    32   79    186   177   177   177   177   177   177    47   177   177   177   177   177   177    92   177   177   177   177 177  177
176  176    186   176  176    186   176  176    186   176  176    186   176  176    186   176   32    32    32    32    32     32     32    32    32    32    32     32     32     32    32    32    32    32    32     32    32    32  32    32   176    186   176  176    186   176  176    186   176  176  176  42    186   32    200   205   205   205  205   186   177   177   177   177   177    47   177   177   177   177   177   177   177   177    92   177   177   177 177  177
176  176    176   176  176    176   176  176    176   176  176    176   176  176    176   176   32    32    32    32    32     32     32    32    32    32    32     32     32     32    32    32    32    32    32     32    32    32  32    32   176    176   176  176    176   176  176    176   176  176  176  42    186   32    32    32    32    32   32    186   177   177   177   177    47   177   177   177   177   177   177   177   177   177   177    92   177   177 177  177
176  176    94    176  176    94    176  176    94    176  176    94    176  176    94    176  176    94    176  176    94     176   176    94    176  176    94     176    176    94    176  176    94    176   176    94    176  176  94    176  176    94    176  176    94    176  176    94    176  176  176  42    200   205   205   205   205   205  205   186   177   177   177    47   177   177   177   177   177   177   177   177   177   177   177   177    92   177 177  177
92    47    32    92    47    32    92    47    32    92    47    32    92    47    32    92    47    32    92    47    32     92     47    32    92    47    32     92     47     32    92    47    32    92    47     32    92    47  32    92    47    32    92    47    32    92    47    32    92   176  176  42    42    42    42    42    42    42   42    186   177   177    47   177   177   177   177   177   177   177   177   177   177   177   177   177   177    92 177  177
92    47    32    92    47    32    92    47    32    92    47    32    92    47    32    92    47    32    92    47    32     92     47    32    92    47    32     92     47     32    92    47    32    92    47     32    92    47  32    92    47    32    92    47    32    92    47    32    92   176  176  176   176   176   176   176   176   176  176   186   177    47   177   177   177   177   177   177   177   177   177   177   177   177   177   177   177   177  92  177
176  176    186   176  176    186   176  176    186   176  176    186   176  176    186   176  176    186   176  176    186    176   176    186   176  176    186    176    176    186   176  176    186   176   176    186   176  176  186   176  176    186   176  176    186   176  176    186   176  176  176  176   176   176   176   176   176   176  176   186    47   177   177   177   177   177   177   177   177   177   177   177   177   177   177   177   177   177 177   92



























