THE CASTLE
80 20
1
0 0 0
201      205      205      205      205      205      205      205      205      205      205      205      205      205      205      205      205      205      205      205      205      205      205      205      205      205   205      205      205      205      205      205      205      205      205      205      205      205      205      205      205      205      205      205      205      205      205      205      205      205      205      205   205      205      205      205      205      205      205      205      205      205      205      205      205      205      205      205      205     205      205      205      205      205      205      205      205      205   205     187
186      176      176      176      176      176      176      176      32       32       32       176      176      176      176      176      176      176      186      176      207      207      157      176      176      157   207      207      176      186      176      176      176      176      176      176      176      176      176      176      176      176      186      176      176      205      205      205      205      205      206      176   176      186      176      176      176      176      176      238      238      238      238      238      238      238      238      238      238     238      238      176      176      176      176      176      176      176   124     186
186      176      176      176      176      176      176      176      32       32       32       176      176      176      176      176      176      176      200      205      205      205      205      205      205      205   205      205      205      188      176      176      176      176      176      176      176      176      176      176      176      176      200      205      205      205      205      205      205      205      205      205   205      188      176      176      176      176      176      176      176      176      176      176      176      176      176      176      176     176      176      176      176      92       176      47       176      176   124     186
186      176      176      176      176      176      176      176      32       32       32       176      176      176      176      176      176      176      176      176      176      176      176      176      176      176   176      176      176      176      176      176      176      176      176      176      176      176      176      176      176      176      176      176      176      176      176      176      176      176      176      176   176      176      176      176      176      176      176      176      176      176      176      176      176      176      176      176      176     176      176      176      176      176      88       176      176      176   124     186
186      176      201      205      205      187      176      176      32       32       32       176      176      176      201      205      205      187      176      176      176      176      201      205      205      187   176      176      176      176      201      205      205      187      176      176      176      176      201      205      205      187      176      176      176      176      201      205      205      187      176      176   176      176      201      205      205      187      176      176      176      176      201      205      205      187      176      176      176     176      176      176      176      47       176      92       176      176   124     186
186      176      186      32       32       186      176      176      32       32       32       176      176      176      186      32       32       186      176      176      176      176      186      32       32       186   176      176      176      176      186      32       32       186      176      176      176      176      186      32       32       186      176      176      176      176      186      32       32       186      176      176   176      176      186      32       32       186      176      176      176      176      186      32       32       186      176      176      176     176      176      176      176      176      176      176      176      176   124     186
186      176      200      205      205      188      176      176      32       32       32       176      176      176      200      205      205      188      176      176      176      176      200      205      205      188   176      176      176      176      200      205      205      188      176      176      176      176      200      205      205      188      176      176      176      176      200      205      205      188      176      176   176      176      200      205      205      188      176      176      176      176      200      205      205      188      176      176      176     201      205      205      205      205      205      205      205      205   205     186
186      176      176      176      176      176      176      176      32       32       32       176      176      176      176      176      176      176      176      176      176      176      176      176      176      176   176      176      176      176      176      176      176      176      176      176      176      176      176      176      176      176      176      176      176      176      176      176      176      176      176      176   176      176      176      176      176      176      176      176      176      176      176      176      176      176      176      176      176     186      201      205      205      205      205      205      205      205   205     186
186      176      176      176      176      176      176      176      32       32       32       176      176      176      176      176      176      176      176      176      176      176      176      176      176      176   176      176      176      176      176      176      176      176      176      176      176      176      176      176      176      176      176      176      176      176      176      176      176      176      176      176   176      176      176      176      176      176      176      176      176      176      176      176      176      176      176      176      176     186      186      176      176      205      205      205      186      186   176     186
 32      32       32       32       32       32       32       32       32       32       32       32       32       32       32       32       32       32       32       32       32       32       32       32       32       32    32       32       32       32       32       32       32       32       32       32       32       32       32       32       32       32       32       32       32       32       32       32       32       32       32       32    32       32       32       32       32       32       32       32       32       32       32       32       32       32       32       32       32      186      186      32       32       219      219      219      186      186   176     186
 32      32       32       32       32       32       32       32       32       32       32       32       32       32       32       32       32       32       32       32       32       32       32       32       32       32    32       32       32       32       32       32       32       32       32       32       32       32       32       32       32       32       32       32       32       32       32       32       32       32       32       32    32       32       32       32       32       32       32       32       32       32       32       32       32       32       32       32       32      186      186      32       32       219      219      219      186      186   176     186
186      176      176      176      176      176      176      176      32       32       32       176      176      176      176      176      176      176      176      176      176      176      176      176      176      176   176      176      176      176      176      176      176      176      176      176      176      176      176      176      176      176      176      176      176      176      176      176      176      176      176      176   176      176      176      176      176      176      176      176      176      176      176      176      176      176      176      176      176     186      186      176      176      205      205      205      186      186   176     186
186      176      176      176      176      176      176      176      32       32       32       176      176      176      176      176      176      176      176      176      176      176      176      176      176      176   176      176      176      176      176      176      176      176      176      176      176      176      176      176      176      176      176      176      176      176      176      176      176      176      176      176   176      176      176      176      176      176      176      176      176      176      176      176      176      176      176      176      176     186      200      205      205      205      205      205      205      205   205     186
186      176      201      205      205      187      176      176      32       32       32       176      176      176      201      205      205      187      176      176      176      176      201      205      205      187   176      176      176      176      201      205      205      187      176      176      176      176      201      205      205      187      176      176      176      176      201      205      205      187      176      176   176      176      201      205      205      187      176      176      176      176      201      205      205      187      176      176      176     200      205      205      205      205      205      205      205      205   205     186
186      176      186      32       32       186      176      176      32       32       32       176      176      176      186      32       32       186      176      176      176      176      186      32       32       186   176      176      176      176      186      32       32       186      176      176      176      176      186      32       32       186      176      176      176      176      186      32       32       186      176      176   176      176      186      32       32       186      176      176      176      176      186      32       32       186      176      176      176     176      176      176      176      176      176      176      176      176   124     186
186      176      200      205      205      188      176      176      32       32       32       176      176      176      200      205      205      188      176      176      176      176      200      205      205      188   176      176      176      176      200      205      205      188      176      176      176      176      200      205      205      188      176      176      176      176      200      205      205      188      176      176   176      176      200      205      205      188      176      176      176      176      200      205      205      188      176      176      176     176      176      176      176      92       176      47       176      176   124     186
186      176      176      176      176      176      176      176      32       32       32       176      176      176      176      176      176      176      176      176      176      176      176      176      176      176   176      176      176      176      176      176      176      176      176      176      176      176      176      176      176      176      176      176      176      176      176      176      176      176      176      176   176      176      176      176      176      176      176      176      176      176      176      176      176      176      176      176      176     176      176      176      176      176      88       176      176      176   124     186
186      176      176      176      176      176      176      176      32       32       32       176      176      176      176      176      176      176      201      205      205      205      205      205      205      205   205      205      205      187      176      176      176      176      176      176      176      176      176      176      176      176      201      205      205      205      205      205      205      205      205      205   205      187      176      176      176      176      176      176      176      176      176      176      176      176      176      176      176     176      176      176      176      47       176      92       176      176   124     186
186      176      176      176      176      176      176      176      32       32       32       176      176      176      176      176      176      176      186      176      245      176      245      176      176      245   176      245      176      186      176      176      176      176      176      176      176      176      176      176      176      176      186      176      176      205      205      205      205      205      157      176   176      186      176      176      176      176      176      95       95       95       95       95       95       95       95       95       95       95      95       176      176      176      176      176      176      176   124     186
200      205      205      205      205      205      205      205      205      205      205      205      205      205      205      205      205      205      205      205      205      205      205      205      205      205   205      205      205      205      205      205      205      205      205      205      205      205      205      205      205      205      205      205      205      205      205      205      205      205      205      205   205      205      205      205      205      205      205      205      205      205      205      205      205      205      205      205      205     205      205      205      205      205      205      205      205      205   205     188